NO ./textures/redbrick.xpm
SO ./textures/bluestone.xpm
WE ./textures/greystone.xpm
EA ./textures/wood.xpm
F 30,39,44
C 30,39,44


11111111111111
1E00000011
1111111111