NO ./textures/redbrick.xpm
SO ./textures/bluestone.xpm
WE ./textures/wall_tex_a.xpm
EA ./textures/wall_tex_b.xpm
F 30,39,44
C 30,39,44


1111111111
1E00000011
1111111111