            NO              ./textures/bluestone.xpm




WE                 ./textures/colorstone.xpm

SO ./textures/wall_tex_a.xpm

              EA ./textures/wood.xpm



F 30,       39,         0044


                C 30, 00039,             +200








        11111111111
            10N011011
            11111 11111
            11111111111
            111111111111
