NO ./textures/metal_1.xpm
EA ./textures/metal_4.xpm
SO ./textures/metal_2.xpm
F 30,39,44
C 30,39,44
WE ./textures/metal_3.xpm


1111111111
1E0011011
1111111111