NO /Users/ahaloui/Desktop/cub3d_parsing/textures/bluestone.xpm

WE /Users/ahaloui/Desktop/cub3d_parsing/textures/colorstone.xpm

SO /Users/ahaloui/Desktop/cub3d_parsing/textures/wall_tex_a.xpm

EA /Users/ahaloui/Desktop/cub3d_parsing/textures/wood.xpm
F 30,39,44
C 30,39,44


1111111111
1E0011011
11111111111
11111111111
111111111111