NO textures/a1.xpm
SO textures/a2.xpm
WE textures/a3.xpm
EA extures/a4.xpm
F 56, 39, 46
C 44, 44, 45

  111111111111111111111111
  100000000000000000000001
  100000000000000000000001
  100000000000000000000001
  100000111110000101010001
  100000100010000000000001
  10W000100010000100010001
  100000100010000000000001
  100000110110000101010001
  100000000000000000000001
  100000000000000000000001
  100000000000000000000001
  100000000000000000000001
  100000000000000000000001
  100000000000000000000001
  100000000000000000000001
  110000000000000000000001
  111100001000000000000001
  110100001000000000000001
  110100001000000000000001
  110100000000000000000001
  110000000000000000000001
  110000000000000000000001
  111111111111111111111111
