NO /Users/ahaloui/Desktop/cub3d_parsing/textures/bluestone.xpm

WE /Users/ahaloui/Desktop/cub3d_parsing/textures/colorstone.xpm

SO /Users/ahaloui/Desktop/cub3d_parsing/textures/wall_tex_a.xpm

EA /Users/ahaloui/Desktop/cub3d_parsing/textures/wood.xpm

C 45, 10, 254

F 50, 50, 54


11111111111111111111111111111111111111111111111111111111111111111111111111111111111111111111111111111111111111111111111111111111111111111
1000000100110000000000001110001111100000000000111111111111111111111111111111111111111111111111111111111111111111111111111111111111111111111111111111111
101100000111000000000000100010101110000000000011111111111111111111111111111111111111111111111111111111111111111111111111111111111111111111111111111111
100100000000000000000000111111001110000000000011111111111111111111111111111111111111111111111111111111111111111111111111111111111111111111111111111111
111111111011000011100000000000011110000000000011111111111111111111111111111111111111111111111111111111111111111111111111111111111111111111111111111111
100000000110000011101011111110000000000000000011111111111111111111111111111111111111111111111111111111111111111111111111111111111111111111111111111111
111101111111110111000000100011101110000000000011111111111111111111111111111111111111111111111111111111111111111111111111111111111111111111111111111111
111101111111110111010100100011110110000000000011111111111111111111111111111111111111111111111111111111111111111111111111111111111111111111111111111111
1100000011010101110000001011111101100000W0000011111111111111111111111111111111111111111111111111111111111111111111111111111111111111111111111111111111
100000000000000011000000100111110110000001000011111111111111111111111111111111111111111111111111111111111111111111111111111111111111111111111111111111
100000000000000011010100100011110110000010000011111111111111111111111111111111111111111111111111111111111111111111111111111111111111111111111111111111
110000011101010111110111000000000000000000000011111111111111111111111111111111111111111111111111111111111111111111111111111111111111111111111111111111
11101111111010111011110100011110110000000000011111111111111111111111111111111111111111111111111111111111111111111111111111111111111111111111111111111
111111111111111111111111111111111111111111111111111111111111111111111111111111111111111111111111111111111111111111111111111111111111111111111111111111
111111111111111111111111111111111111111111111111111111111111111111111111111111111111111111111111111111111111111111111111111111111111111111111111111111
10000000011000000000000111001111100000000000111111111111111111111111111111111111111111111111111111111111111111111111111111111111111111111111111111111
101100000111000000000000100010101110000000000011111111111111111111111111111111111111111111111111111111111111111111111111111111111111111111111111111111
100100000000000000000000111111001110000000000011111111111111111111111111111111111111111111111111111111111111111111111111111111111111111111111111111111
111111111011000011100000000000011110000000000011111111111111111111111111111111111111111111111111111111111111111111111111111111111111111111111111111111
100000000110000011101011111111111110000000000011111111111111111111111111111111111111111111111111111111111111111111111111111111111111111111111111111111
111101111111110111000000100011101110000000000011111111111111111111111111111111111111111111111111111111111111111111111111111111111111111111111111111111
111101111111110111010100100011110110000000000011111111111111111111111111111111111111111111111111111111111111111111111111111111111111111111111111111111
110000001101010111000000101111110110000000000011111111111111111111111111111111111111111111111111111111111111111111111111111111111111111111111111111111
100000000000000011000000100111110110000000000011111111111111111111111111111111111111111111111111111111111111111111111111111111111111111111111111111111
10000000000000001101010010001111011000000000001111111111111111111111111111111111111111111111111111111111111111111111111111111111111111111111111111111
110000011101010111110111000111111010000000000011111111111111111111111111111111111111111111111111111111111111111111111111111111111111111111111111111111
11110111 1110101 1011110100011110110000000000011111111111111111111111111111111111111111111111111111111111111111111111111111111111111111111111111111111
11111111 1111111 1111111111111111111111111111111111111111111111111111111111111111111111111111111111111111111111111111111111111111111111111111111111111
